NO assets/n.xpm
SO assets/s.xpm
WE assets/w.xpm
EA assets/e.xpm

F 195,172,134
C 244,222,194

1111111111111
1000001000001
1001000010001
1000001000001
100100N001001
1010000000001
1000100101001
1000100000001
1111111111111
