    C 125,206,250
 SO   ./textures/greystone.xpm
          F    255,  248, 220
NO                ./textures/colorstone.xpm
WE     ./textures/bluestone.xpm
EA   ./textures/wood.xpm



      1111111111111111111111111111111111111
   111000000001100000000000001
11110000000000000000000000001
11110111111110000000000000001
1100001      10011100000000001
10000011111110001100000000001
10000000000000000000000000001
1100000111010101111100000000111
11110001 1110101 101000000001
11111111111111111111111111111111111111
1000000000000000000000000000000000001
1000000000000000000000N00000000000001
1000000000000000000000000000000000001
11111111111111111111111111111111111111
1                                   1
1                                   1
1                                   1
1                                   1
1                                   1
1                                   1
11111111111111111111111111111111111111
1000000000000000000000000000000000001
11111111111111111111111111111111111111















