F    255,  248, 220
SO   ./textures/greystone.xpm
NO                ./textures/colorstone.xpm
WE     ./textures/bluestone.xpm
EA   ./textures/wood.xpm
C 125   ,206,  250

100000000011000000000000000111111
11110000000000000000000000001
11110111111110000000000000001
1100001     10011100000000001
10000011111110001100000000001
10000000000000000000000000001
11000001110101011111000000E0111
11110001 1110101 101000000001